%%%%%%%%%%%%%%%%%%%%
%o............%....%
%.%%.%%.%%%%%.%.%%.%
%.%..%...........%.%
%.%.%%.%%  %%.%%.%.%
%.%.%..%G GG%..%...%
%.%.%%.%%%%%%..%%%.%
%.%..............%.%
%.%%...%%%%%%.%.%%.%
%....o...P....%...o%
%%%%%%%%%%%%%%%%%%%%
